1111111111111
1P000C00000E1
1111111111111
