111111111111111111111111111
10000000001100000111E111111
100000000000000000000000001
100000000000000000000000001
1000000C0000000000000000001
1000000000000000000000P0001
111111111111111111111111111
