111111111111111111111111111111111111111111
100000000000000000000E00000000000000000001
100000000000000000000000000000000000000001
100000000000000000000000000000000000000001
100000000000000000000000000000000000000001
100000000000000000000000000000000000000001
100000000000000000000000000000000000000001
100000000000000000000100000000000000000001
100000000000000000111000000000000000000001
100000000000000001000100000000000000000001
100000000000000010000100000000000000000001
100000000000000100000100000000000000000001
100000000000000100000100000000000000000001
100000000000000100000100000000000000000001
100000000000000100000100000000000000000001
100000000000000100000100000000000000000001
100000000000000100000100000000000000000001
100000000000000100000100000000000000000001
100000000000000000000000000000000000000001
100000000000000000000000000000000000000001
100000000000000000000000000000000000000001
100000000000000000000000000000000000000001
100000000000000000000000000000000000000001
100000000000000000000000000000000000000001
100000000000000000000000000000000000000001
100000000000000000000000000000000000000001
100000000000000000000000000000000000000001
100000000000000000000000000000000000000001
100000000000000000000000000000000000000001
100000000000000000000000000000000000000001
100000000000000000000000000000000000000001
100000000000000000000000000000000000000001
100000000000000000000000000000000000000001
100000000000000000000000000000000000000001
100000000000000000000P00000000000000000001
111111111111111111111111111111111111111111
