1111111111111
10010000000C1
110011E000001
1111111111111
