1111111111111
10010000E00C1
1P001110E0001
1111111111111
