1111111111111
10010000P00C1
1P0011E000001
1111111111111
